00000000000000000000
01100000100000000100
00001100100110000100
01101100000110011100
01001000000010001000
01001000010010000000
01000000010010000000
01000000110000100000
00001011110001100100
00000010010001100100
00010010000001100100
01110010000000000100
00010010011111000000
00010000000000000000
00000000000000000000
