00011000000000000000

00011000000002222222

22211200000002222222

22211200000000000000

00011000000000000000

00011000000000000000

00011111111111110000

00011111111111110000

00000000000000110000

00000000000022112222

00000000000222112222

22222200002200110000

22222200002200110000

22222200002200110000

00000000002200110000

11111111111111110000

00000000002200110000

00000000002200110000

00000000002200110000

00000000000000110000