20001020112002112102
10102221021110002011
11201121121011001021
00222221202000101111
01221021110111210120
01101210221100120201
12112110010001100002
10000021212022210121
21211021101020221111
00110220020221210212
02212010210121221212
22210112001000001221
20020011111011200022
10202020102022210011
02022102202210112122
22112121220122022002
10222211001111102220
20201112120111111102
10011010102020211112
02221012211002210102
