00000000000000000000
01101111000011101110
00001111011011000000
01101100011011000110
01101101011000001110
01101101000011101110
01101101011011100000
01100000011000101110
01100000001010100000
01100111101010101110
00000111101010101110
01100000000000000000
00001011011101110111
01111011011101110111
00000000000000110000
