00000000000000000000
00000000222000000000
00000002220000200000
00111000000002020000
01110000000020002000
00000011000002020000
00000011000000200000
00000000000000000000
00020000000000000000
00020000000001100000
00020000000011110000
00020000000001100000
00000000000000000000
00000111000000000000
00000111000000020000
00000111000000222000
00000000000002222200
00222000000000222000
00000000000000020000
00000000000000000000
