00010000000000000000
00010000000002222222
00010000000002222222
00010000000000000000
00010000000000000000
00010000000000000000
00010000000000000000
00011111111111100000
00000000000000100000
00000000000000100222
00000000000000100222
00000000002200100000
22222200002200100000
22222200002200100000
00000000002200100000
00000000002200100000
00000000002200100000
00000000002200100000
00000000002200100000
00000000000000100000